,date,confirmed,healed,dead,confirmed_cumulative,healed_cumulative,dead_cumulative,active
1,13/03/2020,2,0,0,2,0,0,2
2,14/03/2020,3,0,0,5,0,0,5
3,15/03/2020,3,0,0,8,0,0,8
4,16/03/2020,7,0,0,15,0,0,15
5,17/03/2020,4,0,0,19,0,0,19
6,18/03/2020,1,0,0,20,0,0,20
7,19/03/2020,1,0,0,21,0,0,21
8,20/03/2020,3,0,0,24,0,0,24
9,21/03/2020,7,0,0,31,0,0,31
10,22/03/2020,2,0,1,33,0,1,32
11,23/03/2020,28,0,0,61,0,1,60
12,24/03/2020,2,0,0,63,0,1,62
13,25/03/2020,8,0,0,71,0,1,70
14,26/03/2020,15,1,0,86,1,1,84
15,27/03/2020,2,0,0,88,1,1,86
16,28/03/2020,3,0,0,91,1,1,89
17,29/03/2020,4,0,0,95,1,1,93
18,30/03/2020,12,0,0,107,1,1,105
19,31/03/2020,6,5,0,113,6,1,106
20,01/04/2020,13,4,0,126,10,1,115
21,02/04/2020,1,0,0,127,10,1,116
22,03/04/2020,6,6,0,133,16,1,116
23,04/04/2020,8,7,0,141,23,1,117
24,05/04/2020,5,0,0,146,23,1,122
25,06/04/2020,20,1,2,166,24,3,139
26,07/04/2020,19,6,2,185,30,5,150
27,08/04/2020,39,7,1,224,37,6,181
28,09/04/2020,3,1,1,227,38,7,182
29,10/04/2020,23,14,0,250,52,7,191
30,11/04/2020,33,6,0,283,58,7,218
31,12/04/2020,79,1,0,362,59,7,296
32,13/04/2020,15,4,1,377,63,8,306
33,14/04/2020,10,3,0,387,66,8,313
34,15/04/2020,36,5,1,423,71,9,343
35,16/04/2020,26,8,2,449,79,11,359
36,17/04/2020,31,5,1,480,84,12,384
37,18/04/2020,30,9,0,510,93,12,405
38,19/04/2020,51,9,0,561,102,12,447
39,20/04/2020,37,21,3,598,123,15,460
40,21/04/2020,6,5,3,604,128,18,458
41,22/04/2020,26,10,0,630,138,18,474
42,23/04/2020,39,21,1,669,159,19,491
43,24/04/2020,34,4,0,703,163,19,521
44,25/04/2020,28,3,1,731,166,20,545
45,26/04/2020,33,4,2,764,170,22,572
46,27/04/2020,22,39,3,786,209,25,552
47,28/04/2020,12,35,0,798,244,25,529
48,29/04/2020,10,21,0,808,265,25,518
49,30/04/2020,12,26,0,820,291,25,504
50,01/05/2020,9,31,0,829,322,25,482
51,02/05/2020,11,42,0,840,364,25,451
52,03/05/2020,11,18,1,851,382,26,443
53,04/05/2020,4,22,0,855,404,26,425
54,05/05/2020,1,87,0,856,491,26,339
55,06/05/2020,4,43,0,860,534,26,300
56,07/05/2020,1,28,1,861,562,27,272
57,08/05/2020,1,62,1,862,624,28,210
58,09/05/2020,8,31,0,870,655,28,187
59,10/05/2020,14,2,0,884,657,28,199
60,11/05/2020,11,2,0,895,659,28,208
61,12/05/2020,24,14,1,919,673,29,217
62,13/05/2020,8,0,0,927,673,29,225
63,14/05/2020,18,19,0,945,692,29,224
64,15/05/2020,10,1,0,955,693,29,233
65,16/05/2020,23,22,0,978,715,29,234
66,17/05/2020,7,23,0,985,738,29,218
67,18/05/2020,3,18,0,988,756,29,203
68,19/05/2020,1,18,0,989,774,29,186
69,20/05/2020,14,0,0,1003,774,29,200
70,21/05/2020,1,0,0,1004,774,29,201
71,22/05/2020,21,10,0,1025,784,29,212
72,23/05/2020,7,3,0,1032,787,29,216
73,24/05/2020,0,4,0,1032,791,29,212
74,25/05/2020,6,2,1,1038,793,30,215
75,26/05/2020,9,3,0,1047,796,30,221
76,27/05/2020,1,7,0,1048,803,30,215
77,28/05/2020,4,19,0,1052,822,30,200
78,29/05/2020,12,9,0,1064,831,30,203
79,30/05/2020,6,12,0,1070,843,30,197
80,31/05/2020,13,2,0,1083,845,30,208
81,01/06/2020,27,0,0,1110,845,30,235
82,02/06/2020,11,4,0,1121,849,30,242
83,03/06/2020,21,24,0,1142,873,30,239
84,04/06/2020,4,3,0,1146,876,30,240
85,05/06/2020,12,2,0,1158,878,30,250
86,06/06/2020,36,8,1,1194,886,31,277
87,07/06/2020,40,6,0,1234,892,31,311
88,08/06/2020,29,22,0,1263,914,31,318
89,09/06/2020,6,0,0,1269,914,31,324
90,10/06/2020,29,1,0,1298,915,31,352
91,11/06/2020,28,8,0,1326,923,31,372
92,12/06/2020,58,0,0,1384,923,31,430
93,13/06/2020,53,7,1,1437,930,32,475
94,14/06/2020,49,24,1,1486,954,33,499
95,15/06/2020,129,10,0,1615,964,33,618
96,16/06/2020,141,5,1,1756,969,34,753
97,17/06/2020,77,0,0,1833,969,34,830
98,18/06/2020,83,5,0,1916,974,34,908
99,19/06/2020,82,7,0,1998,981,34,983
100,20/06/2020,75,38,1,2073,1019,35,1019
101,21/06/2020,96,30,1,2169,1049,36,1084
102,22/06/2020,47,22,3,2216,1071,39,1106
103,23/06/2020,52,41,0,2268,1112,39,1117
104,24/06/2020,95,64,1,2363,1176,40,1147
105,25/06/2020,69,71,2,2432,1247,42,1143
106,26/06/2020,62,61,3,2494,1308,45,1141
107,27/06/2020,96,86,3,2590,1394,48,1148
108,28/06/2020,87,31,1,2677,1425,49,1203
109,29/06/2020,122,81,1,2799,1506,50,1243
110,30/06/2020,79,71,1,2878,1577,51,1250
111,01/07/2020,113,67,3,2991,1644,54,1293
112,02/07/2020,73,63,1,3064,1707,55,1302
113,03/07/2020,114,117,3,3178,1824,58,1296
114,04/07/2020,178,50,8,3356,1874,66,1416
115,05/07/2020,152,28,9,3508,1902,75,1531
116,06/07/2020,195,44,4,3703,1946,79,1678
117,07/07/2020,183,57,3,3886,2003,82,1801
118,08/07/2020,214,60,4,4100,2063,86,1951
119,09/07/2020,207,32,8,4307,2095,94,2118
120,10/07/2020,205,61,3,4512,2156,97,2259
121,11/07/2020,203,71,4,4715,2227,101,2387
122,12/07/2020,216,40,1,4931,2267,102,2562
123,13/07/2020,187,103,6,5118,2370,108,2640
124,14/07/2020,119,92,4,5237,2462,112,2663
125,15/07/2020,132,83,6,5369,2545,118,2706
126,16/07/2020,103,95,6,5472,2640,124,2708
127,17/07/2020,145,171,6,5617,2811,130,2676
128,18/07/2020,118,157,6,5735,2968,136,2631
129,19/07/2020,142,101,3,5877,3069,139,2669
130,20/07/2020,168,157,5,6045,3226,144,2675
131,21/07/2020,241,143,6,6286,3369,150,2767
132,22/07/2020,181,136,8,6467,3505,158,2804
133,23/07/2020,213,109,6,6680,3614,164,2902
134,24/07/2020,237,139,5,6917,3753,169,2995
135,25/07/2020,220,121,8,7137,3874,177,3086
136,26/07/2020,276,153,8,7413,4027,185,3201
137,27/07/2020,239,102,7,7652,4129,192,3331
138,28/07/2020,194,138,4,7846,4267,196,3383
139,29/07/2020,258,196,16,8104,4463,212,3429
140,30/07/2020,226,115,15,8330,4578,227,3525
141,31/07/2020,224,152,9,8554,4730,236,3588
142,01/08/2020,245,133,13,8799,4863,249,3687
143,02/08/2020,250,126,7,9049,4989,256,3804
144,03/08/2020,225,201,13,9274,5190,269,3815
145,04/08/2020,218,156,15,9492,5346,284,3862
146,05/08/2020,196,134,16,9688,5480,300,3908
147,06/08/2020,181,125,3,9869,5605,303,3961
148,07/08/2020,190,197,12,10059,5802,315,3942
149,08/08/2020,188,142,12,10247,5944,327,3976
150,09/08/2020,172,114,14,10419,6058,341,4020
151,10/08/2020,171,190,13,10590,6248,354,3988
152,11/08/2020,205,163,11,10795,6411,365,4019
153,12/08/2020,193,205,8,10988,6616,373,3999
154,13/08/2020,142,201,8,11130,6817,381,3932
155,14/08/2020,145,144,9,11275,6961,390,3924
156,15/08/2020,141,230,11,11416,7191,401,3824
157,16/08/2020,129,152,9,11545,7343,410,3792
158,17/08/2020,140,219,6,11685,7562,416,3707
159,18/08/2020,162,122,9,11847,7684,425,3738
160,19/08/2020,158,245,13,12005,7929,438,3638
161,20/08/2020,162,220,10,12167,8149,448,3570
162,21/08/2020,169,197,9,12336,8346,457,3533
163,22/08/2020,111,159,10,12447,8505,467,3475
164,23/08/2020,99,152,13,12546,8657,480,3409
165,24/08/2020,136,131,8,12682,8788,488,3406
166,25/08/2020,157,154,4,12839,8942,492,3405
167,26/08/2020,141,143,6,12980,9085,498,3397
168,27/08/2020,119,154,1,13099,9239,499,3361
169,28/08/2020,116,116,9,13215,9355,508,3352
170,29/08/2020,119,118,8,13334,9473,516,3345
171,30/08/2020,120,122,9,13454,9595,525,3334
172,31/08/2020,147,197,8,13601,9792,533,3276
173,01/09/2020,112,131,6,13713,9923,539,3251
174,02/09/2020,78,190,9,13791,10113,548,3130
175,03/09/2020,119,187,3,13910,10300,551,3059
176,04/09/2020,117,131,5,14027,10431,556,3040
177,05/09/2020,92,115,7,14119,10546,563,3010
178,06/09/2020,85,97,5,14204,10643,568,2993
179,07/09/2020,97,139,0,14301,10782,568,2951
180,08/09/2020,76,144,6,14377,10926,574,2877
181,09/09/2020,69,107,7,14446,11033,581,2832
182,10/09/2020,50,117,5,14496,11150,586,2760
183,11/09/2020,70,122,3,14566,11272,589,2705
184,12/09/2020,71,163,7,14637,11435,596,2606
185,13/09/2020,55,150,4,14692,11585,600,2507
186,14/09/2020,71,199,1,14763,11784,601,2378
187,15/09/2020,76,165,3,14839,11949,604,2286
188,16/09/2020,43,239,3,14882,12188,607,2087
189,17/09/2020,57,137,4,14939,12325,611,2003
190,18/09/2020,63,126,0,15002,12451,611,1940
191,19/09/2020,61,119,2,15063,12570,613,1880
192,20/09/2020,79,104,2,15142,12674,615,1853
193,21/09/2020,66,141,0,15208,12815,615,1778
194,22/09/2020,62,85,1,15270,12900,616,1754
195,23/09/2020,63,87,0,15333,12987,616,1730
196,24/09/2020,46,101,1,15379,13088,617,1674
197,25/09/2020,46,77,2,15425,13165,619,1641
198,26/09/2020,47,113,3,15472,13278,622,1572
199,27/09/2020,48,142,3,15520,13420,625,1475
200,28/09/2020,54,72,0,15574,13492,625,1457
201,29/09/2020,46,62,0,15620,13554,625,1441
202,30/09/2020,43,123,2,15663,13677,627,1359
203,01/10/2020,42,54,0,15705,13731,627,1347
204,02/10/2020,53,56,3,15758,13787,630,1341
205,03/10/2020,56,69,0,15814,13856,630,1328
206,04/10/2020,41,73,2,15855,13929,632,1294
207,05/10/2020,34,122,3,15889,14051,635,1203
208,06/10/2020,49,92,3,15938,14143,638,1157
209,07/10/2020,33,46,0,15971,14189,638,1144
210,08/10/2020,79,61,3,16050,14250,641,1159
211,09/10/2020,80,32,4,16130,14282,645,1203
212,10/10/2020,49,53,2,16179,14335,647,1197
213,11/10/2020,68,33,1,16247,14368,648,1231
214,12/10/2020,98,37,1,16345,14405,649,1291
215,13/10/2020,80,55,1,16425,14460,650,1315
216,14/10/2020,77,59,0,16502,14519,650,1333
217,15/10/2020,104,42,2,16606,14561,652,1393
218,16/10/2020,148,56,0,16754,14617,652,1485
219,17/10/2020,137,49,1,16891,14666,653,1572
220,18/10/2020,118,50,3,17009,14716,656,1637
221,19/10/2020,130,71,1,17139,14787,657,1695
222,20/10/2020,124,49,0,17263,14836,657,1770
223,21/10/2020,159,58,0,17422,14894,657,1871
224,22/10/2020,169,85,2,17591,14979,659,1953
225,23/10/2020,166,55,2,17757,15034,661,2062
226,24/10/2020,186,54,2,17943,15088,663,2192
227,25/10/2020,205,62,3,18148,15150,666,2332
228,26/10/2020,197,48,3,18345,15198,669,2478
229,27/10/2020,281,97,4,18626,15295,673,2658
230,28/10/2020,284,72,1,18910,15367,674,2869
231,29/10/2020,418,67,4,19328,15434,678,3216
232,30/10/2020,514,86,3,19842,15520,681,3641
233,31/10/2020,337,91,7,20179,15611,688,3880
234,01/11/2020,486,30,9,20665,15641,697,4327
235,02/11/2020,334,81,8,20999,15722,705,4572
236,03/11/2020,546,107,9,21545,15829,714,5002
237,04/11/2020,661,92,6,22206,15921,720,5565
238,05/11/2020,728,60,12,22934,15981,732,6221
239,06/11/2020,491,66,12,23425,16047,744,6634
240,07/11/2020,730,75,11,24155,16122,755,7278
241,08/11/2020,637,104,13,24792,16226,768,7798
242,09/11/2020,596,136,5,25388,16362,773,8253
243,10/11/2020,733,137,4,26121,16499,777,8845
244,11/11/2020,767,186,8,26888,16685,785,9418
245,12/11/2020,963,177,13,27851,16862,798,10191
246,13/11/2020,765,193,11,28616,17055,809,10752
247,14/11/2020,501,250,13,29117,17305,822,10990
248,15/11/2020,688,236,11,29805,17541,833,11431
249,16/11/2020,690,337,16,30495,17878,849,11768
250,17/11/2020,720,469,11,31215,18347,860,12008
251,18/11/2020,807,677,14,32022,19024,874,12124
252,19/11/2020,855,748,11,32877,19772,885,12220
253,20/11/2020,711,721,19,33588,20493,904,12191
254,21/11/2020,707,550,10,34295,21043,914,12338
255,22/11/2020,645,353,12,34940,21396,926,12618
256,23/11/2020,609,350,13,35549,21746,939,12864
257,24/11/2020,704,391,9,36253,22137,948,13168
258,25/11/2020,775,553,15,37028,22690,963,13375
259,26/11/2020,764,584,12,37792,23274,975,13543
260,27/11/2020,639,480,14,38431,23754,989,13688
261,28/11/2020,626,673,16,39057,24427,1005,13625
262,29/11/2020,539,574,11,39596,25001,1016,13579
263,30/11/2020,521,585,10,40117,25586,1026,13505
264,01/12/2020,555,324,14,40672,25910,1040,13722
265,02/12/2020,627,543,22,41299,26453,1062,13784
266,03/12/2020,478,690,11,41777,27143,1073,13561
267,04/12/2020,560,678,14,42337,27821,1087,13429
268,05/12/2020,468,683,19,42805,28504,1106,13195
269,06/12/2020,519,926,14,43324,29430,1120,12774
270,07/12/2020,557,727,17,43881,30157,1137,12587
271,08/12/2020,561,884,11,44442,31041,1148,12253
272,09/12/2020,562,761,13,45004,31802,1161,12041
273,10/12/2020,590,696,13,45594,32498,1174,11922
274,11/12/2020,524,566,12,46118,33064,1186,11868
275,12/12/2020,462,536,12,46580,33600,1198,11782
276,13/12/2020,329,555,5,46909,34155,1203,11551
277,14/12/2020,294,482,17,47203,34637,1220,11346
278,15/12/2020,296,319,5,47499,34956,1225,11318
279,16/12/2020,453,483,8,47952,35439,1233,11280
280,17/12/2020,385,351,7,48337,35790,1240,11307
281,18/12/2020,345,436,8,48682,36226,1248,11208
282,19/12/2020,223,342,8,48905,36568,1256,11081
283,20/12/2020,264,205,6,49169,36773,1262,11134
284,21/12/2020,137,382,10,49306,37155,1272,10879
285,22/12/2020,271,417,12,49577,37572,1284,10721
286,23/12/2020,309,546,6,49886,38118,1290,10478
287,24/12/2020,249,538,8,50135,38656,1298,10181
288,25/12/2020,270,478,7,50405,39134,1305,9966
289,26/12/2020,215,428,4,50620,39562,1309,9749
290,27/12/2020,181,407,8,50801,39969,1317,9515
291,28/12/2020,109,454,8,50910,40423,1325,9162
292,29/12/2020,234,564,7,51144,40987,1332,8825
293,30/12/2020,184,420,3,51328,41407,1335,8586
294,31/12/2020,174,445,1,51502,41852,1336,8314
295,01/01/2021,229,363,4,51731,42215,1340,8176
296,02/01/2021,234,420,4,51965,42635,1344,7986
297,03/01/2021,169,313,7,52134,42948,1351,7835
298,04/01/2021,199,430,4,52333,43378,1355,7600
299,05/01/2021,301,457,2,52634,43835,1357,7442
300,06/01/2021,309,601,6,52943,44436,1363,7144
301,07/01/2021,321,564,5,53264,45000,1368,6896
302,08/01/2021,259,613,7,53523,45613,1375,6535
303,09/01/2021,253,646,2,53776,46259,1377,6140
304,10/01/2021,206,389,6,53982,46648,1383,5951
305,11/01/2021,279,431,4,54261,47079,1387,5795
306,12/01/2021,299,526,1,54560,47605,1388,5567
307,13/01/2021,279,441,4,54839,48046,1392,5401
308,14/01/2021,296,526,7,55135,48572,1399,5164
309,15/01/2021,363,418,6,55498,48990,1405,5103
310,16/01/2021,353,279,5,55851,49269,1410,5172
311,17/01/2021,267,163,1,56118,49432,1411,5275
312,18/01/2021,294,281,9,56412,49713,1420,5279
313,19/01/2021,320,269,6,56732,49982,1426,5324
314,20/01/2021,296,202,7,57028,50184,1433,5411
315,21/01/2021,289,303,14,57317,50487,1447,5383
316,22/01/2021,379,244,3,57696,50731,1450,5515
317,23/01/2021,392,222,6,58088,50953,1456,5679
318,24/01/2021,311,128,10,58399,51081,1466,5852
319,25/01/2021,288,256,5,58687,51337,1471,5879
320,26/01/2021,301,181,8,58988,51518,1479,5991
321,27/01/2021,316,195,3,59304,51713,1482,6109
322,28/01/2021,342,235,5,59646,51948,1487,6211
323,29/01/2021,285,260,5,59931,52208,1492,6231
324,30/01/2021,287,229,6,60218,52437,1498,6283
325,31/01/2021,282,184,5,60500,52621,1503,6376
326,01/02/2021,245,189,3,60745,52810,1506,6429
327,02/02/2021,341,207,3,61086,53017,1509,6560
328,03/02/2021,318,214,5,61404,53231,1514,6659
329,04/02/2021,284,224,5,61688,53455,1519,6714
330,05/02/2021,321,313,1,62009,53768,1520,6721
331,06/02/2021,249,274,3,62258,54042,1523,6693
332,07/02/2021,290,189,3,62548,54231,1526,6791
333,08/02/2021,234,209,2,62782,54440,1528,6814
334,09/02/2021,307,221,4,63089,54661,1532,6896
335,10/02/2021,344,230,2,63433,54891,1534,7008
336,11/02/2021,372,333,6,63805,55224,1540,7041
337,12/02/2021,290,336,4,64095,55560,1544,6991
338,13/02/2021,246,201,0,64341,55761,1544,7036
339,14/02/2021,178,267,1,64519,56028,1545,6946
340,15/02/2021,249,316,3,64768,56344,1548,6876
341,16/02/2021,297,311,5,65065,56655,1553,6857
342,17/02/2021,285,319,5,65350,56974,1558,6818
343,18/02/2021,340,411,10,65690,57385,1568,6737
344,19/02/2021,292,556,3,65982,57941,1571,6470
345,20/02/2021,398,228,1,66380,58169,1572,6639
346,21/02/2021,260,190,3,66640,58359,1575,6706
347,22/02/2021,368,241,4,67008,58600,1579,6829
348,23/02/2021,461,319,3,67469,58919,1582,6968
349,24/02/2021,437,255,5,67906,59174,1587,7145
350,25/02/2021,445,264,5,68351,59438,1592,7321
351,26/02/2021,426,205,3,68777,59643,1595,7539
352,27/02/2021,453,206,4,69230,59849,1599,7782
353,28/02/2021,467,214,9,69697,60063,1608,8026
354,01/03/2021,488,270,8,70185,60333,1616,8236
355,02/03/2021,568,295,4,70753,60628,1620,8505
356,03/03/2021,591,386,7,71344,61014,1627,8703
357,04/03/2021,564,380,7,71908,61394,1634,8880
358,05/03/2021,592,291,6,72500,61685,1640,9175
359,06/03/2021,548,301,9,73048,61986,1649,9413
360,07/03/2021,587,212,6,73635,62198,1655,9782
361,08/03/2021,444,452,13,74079,62650,1668,9761
362,09/03/2021,669,333,6,74748,62983,1674,10091
363,10/03/2021,632,397,8,75380,63380,1682,10318
364,11/03/2021,730,512,6,76110,63892,1688,10530
365,12/03/2021,578,470,8,76688,64362,1696,10630
366,13/03/2021,565,304,6,77253,64666,1702,10885
367,14/03/2021,574,394,13,77827,65060,1715,11052
368,15/03/2021,553,534,8,78380,65594,1723,11063
369,16/03/2021,709,385,8,79089,65979,1731,11379
370,17/03/2021,704,342,5,79793,66321,1736,11736
371,18/03/2021,828,744,8,80621,67065,1744,11812
372,19/03/2021,771,666,8,81392,67731,1752,11909
373,20/03/2021,793,352,8,82185,68083,1760,12342
374,21/03/2021,827,518,16,83012,68601,1776,12635
375,22/03/2021,705,522,10,83717,69123,1786,12808
376,23/03/2021,781,764,17,84498,69887,1803,12808
377,24/03/2021,836,700,10,85334,70587,1813,12934
378,25/03/2021,860,682,6,86194,71269,1819,13106
379,26/03/2021,873,544,11,87067,71813,1830,13424
380,27/03/2021,914,602,10,87981,72415,1840,13726
381,28/03/2021,774,903,4,88755,73318,1844,13593
382,29/03/2021,752,665,14,89507,73983,1858,13666
383,30/03/2021,923,771,14,90430,74754,1872,13804
384,31/03/2021,975,893,12,91405,75647,1884,13874
385,01/04/2021,793,755,10,92198,76402,1894,13902
386,02/04/2021,777,566,12,92975,76968,1906,14101
387,03/04/2021,680,465,9,93655,77433,1915,14307
388,04/04/2021,512,524,11,94167,77957,1926,14284
389,05/04/2021,489,745,8,94656,78702,1934,14020
390,06/04/2021,685,788,14,95341,79490,1948,13903
391,07/04/2021,871,642,12,96212,80132,1960,14120
392,08/04/2021,684,702,7,96896,80834,1967,14095
393,09/04/2021,571,727,9,97467,81561,1976,13930
394,10/04/2021,529,503,12,97996,82064,1988,13944
395,11/04/2021,345,518,8,98341,82582,1996,13763
396,12/04/2021,494,1009,12,98835,83591,2008,13236
397,13/04/2021,701,737,14,99536,84328,2022,13186
398,14/04/2021,599,868,17,100135,85196,2039,12900
399,15/04/2021,520,646,14,100655,85842,2053,12760
400,16/04/2021,498,641,8,101153,86483,2061,12609
401,17/04/2021,364,529,11,101517,87012,2072,12433
402,18/04/2021,277,411,14,101794,87423,2086,12285
403,19/04/2021,442,957,14,102236,88380,2100,11756
404,20/04/2021,506,761,5,102742,89141,2105,11496
405,21/04/2021,382,507,5,103124,89648,2110,11366
406,22/04/2021,356,680,8,103480,90328,2118,11034
407,23/04/2021,335,484,7,103815,90812,2125,10878
408,24/04/2021,227,615,4,104042,91427,2129,10486
409,25/04/2021,154,545,11,104196,91972,2140,10084
410,26/04/2021,194,599,8,104390,92571,2148,9671
411,27/04/2021,327,508,5,104717,93079,2153,9485
412,28/04/2021,269,449,9,104986,93528,2162,9296
413,29/04/2021,202,646,11,105188,94174,2173,8841
414,30/04/2021,187,456,5,105375,94630,2178,8567
415,01/05/2021,160,415,5,105535,95045,2183,8307
416,02/05/2021,101,421,4,105636,95466,2187,7983
417,03/05/2021,75,546,4,105711,96012,2191,7508
418,04/05/2021,153,310,4,105864,96322,2195,7347
419,05/05/2021,158,346,3,106022,96668,2198,7156
420,06/05/2021,170,389,4,106192,97057,2202,6933
421,07/05/2021,153,327,1,106345,97384,2203,6758
422,08/05/2021,97,291,5,106442,97675,2208,6559
423,09/05/2021,47,202,2,106489,97877,2210,6402
424,10/05/2021,49,346,3,106538,98223,2213,6102
425,11/05/2021,113,316,4,106651,98539,2217,5895
426,12/05/2021,103,248,1,106754,98787,2218,5749
427,13/05/2021,49,310,2,106803,99097,2220,5486
428,14/05/2021,40,358,3,106843,99455,2223,5165
429,15/05/2021,71,173,2,106914,99628,2225,5061
430,16/05/2021,25,196,1,106939,99824,2226,4889
431,17/05/2021,64,409,1,107003,100233,2227,4543
432,18/05/2021,62,379,8,107065,100612,2235,4218
433,19/05/2021,55,331,2,107120,100943,2237,3940
434,20/05/2021,58,156,2,107178,101099,2239,3840
435,21/05/2021,35,180,0,107213,101279,2239,3695
436,22/05/2021,31,95,0,107244,101374,2239,3631
437,23/05/2021,14,93,1,107258,101467,2240,3551
438,24/05/2021,11,258,1,107269,101725,2241,3303
439,25/05/2021,44,152,0,107313,101877,2241,3195
440,26/05/2021,23,230,1,107336,102107,2242,2987
441,27/05/2021,18,412,0,107354,102519,2242,2593
442,28/05/2021,28,133,1,107382,102652,2243,2487
443,29/05/2021,23,130,0,107405,102782,2243,2380
444,30/05/2021,5,184,0,107410,102966,2243,2201
445,31/05/2021,19,177,0,107429,103143,2243,2043
446,01/06/2021,18,239,0,107447,103382,2243,1822
447,02/06/2021,12,182,0,107459,103564,2243,1652
448,03/06/2021,7,147,1,107466,103711,2244,1511
449,04/06/2021,20,197,0,107486,103908,2244,1334
450,05/06/2021,11,146,1,107497,104054,2245,1198
451,06/06/2021,10,134,0,107507,104188,2245,1074
452,07/06/2021,5,155,1,107512,104343,2246,923
453,08/06/2021,21,111,1,107533,104454,2247,832
454,09/06/2021,11,109,1,107544,104563,2248,733
455,10/06/2021,10,116,0,107554,104679,2248,627
456,11/06/2021,17,112,1,107571,104791,2249,531
457,12/06/2021,7,103,1,107578,104894,2250,434
458,13/06/2021,5,94,0,107583,104988,2250,345
459,14/06/2021,12,119,0,107595,105107,2250,238
460,15/06/2021,15,67,0,107610,105174,2250,186
461,16/06/2021,10,12,0,107620,105186,2250,184
462,17/06/2021,9,14,0,107629,105200,2250,179
463,18/06/2021,16,18,1,107645,105218,2251,176
464,19/06/2021,8,9,1,107653,105227,2252,174
465,20/06/2021,2,14,0,107655,105241,2252,162
466,21/06/2021,18,14,1,107673,105255,2253,165
467,22/06/2021,20,19,1,107693,105274,2254,165
468,23/06/2021,14,6,2,107707,105280,2256,171
469,24/06/2021,7,12,0,107714,105292,2256,166
470,25/06/2021,11,6,1,107725,105298,2257,170
471,26/06/2021,14,12,1,107739,105310,2258,171
472,27/06/2021,4,5,0,107743,105315,2258,170
473,28/06/2021,6,10,0,107749,105325,2258,166
474,29/06/2021,9,8,0,107758,105333,2258,167
475,30/06/2021,10,12,0,107768,105345,2258,165
476,01/07/2021,17,8,2,107785,105353,2260,172
477,02/07/2021,3,9,0,107788,105362,2260,166
478,03/07/2021,9,14,1,107797,105376,2261,160
479,04/07/2021,3,5,0,107800,105381,2261,158
480,05/07/2021,10,16,0,107810,105397,2261,152
481,06/07/2021,9,8,1,107819,105405,2262,152
482,07/07/2021,8,7,2,107827,105412,2264,151
483,08/07/2021,8,10,0,107835,105422,2264,149
484,09/07/2021,7,22,0,107842,105444,2264,134
485,10/07/2021,12,13,0,107854,105457,2264,133
486,11/07/2021,5,6,0,107859,105463,2264,132
487,12/07/2021,8,32,0,107867,105495,2264,108
488,13/07/2021,12,14,0,107879,105509,2264,106
489,14/07/2021,4,5,0,107883,105514,2264,105
490,15/07/2021,11,17,0,107894,105531,2264,99
491,16/07/2021,2,3,0,107896,105534,2264,98
492,17/07/2021,7,2,0,107903,105536,2264,103
493,18/07/2021,3,2,0,107906,105538,2264,104
494,19/07/2021,15,11,1,107921,105549,2265,107
495,20/07/2021,5,8,0,107926,105557,2265,104
496,21/07/2021,28,18,0,107954,105575,2265,114
497,22/07/2021,19,7,0,107973,105582,2265,126
498,23/07/2021,19,8,0,107992,105590,2265,137
499,24/07/2021,25,1,0,108017,105591,2265,161
500,25/07/2021,14,6,0,108031,105597,2265,169
501,26/07/2021,42,16,0,108073,105613,2265,195
502,27/07/2021,58,3,0,108131,105616,2265,250
503,28/07/2021,72,17,0,108203,105633,2265,305
504,29/07/2021,70,8,1,108273,105641,2266,366
505,30/07/2021,92,16,0,108365,105657,2266,442
506,31/07/2021,100,3,0,108465,105660,2266,539
507,01/08/2021,48,5,0,108513,105665,2266,582
508,02/08/2021,110,2,1,108623,105667,2267,689
509,03/08/2021,221,21,1,108844,105688,2268,888
510,04/08/2021,195,16,2,109039,105704,2270,1065
511,05/08/2021,271,15,0,109310,105719,2270,1321
512,06/08/2021,352,13,1,109662,105732,2271,1659
513,07/08/2021,269,25,0,109931,105757,2271,1903
514,08/08/2021,263,8,0,110194,105765,2271,2158
515,09/08/2021,562,78,2,110756,105843,2273,2640
516,10/08/2021,888,38,1,111644,105881,2274,3489
517,11/08/2021,1009,82,2,112653,105963,2276,4414
518,12/08/2021,1128,46,3,113781,106009,2279,5493
519,13/08/2021,1370,47,1,115151,106056,2280,6815
520,14/08/2021,1096,53,4,116247,106109,2284,7854
521,15/08/2021,740,48,2,116987,106157,2286,8544
522,16/08/2021,1765,121,5,118752,106278,2291,10183
523,17/08/2021,2110,130,4,120862,106408,2295,12159
524,18/08/2021,2236,138,8,123098,106546,2303,14249
525,19/08/2021,2250,154,4,125348,106700,2307,16341
526,20/08/2021,2279,325,8,127627,107025,2315,18287
527,21/08/2021,1682,263,11,129309,107288,2326,19695
528,22/08/2021,1067,278,17,130376,107566,2343,20467
529,23/08/2021,1901,433,13,132277,107999,2356,21922
530,24/08/2021,2541,604,14,134818,108603,2370,23845
531,25/08/2021,2295,1183,18,137113,109786,2388,24939
532,26/08/2021,2098,1614,16,139211,111400,2404,25407
533,27/08/2021,1891,1483,18,141102,112883,2422,25797
534,28/08/2021,1630,816,36,142732,113699,2458,26575
535,29/08/2021,932,962,20,143664,114661,2478,26525
536,30/08/2021,1383,996,26,145047,115657,2504,26886
537,31/08/2021,1894,1354,22,146941,117011,2526,27404
538,01/09/2021,1612,2460,32,148553,119471,2558,26524
539,02/09/2021,1448,1421,26,150001,120892,2584,26525
540,03/09/2021,1278,1248,21,151279,122140,2605,26534
541,04/09/2021,890,1712,24,152169,123852,2629,25688
542,05/09/2021,489,859,28,152658,124711,2657,25290
543,06/09/2021,920,1698,28,153578,126409,2685,24484
544,07/09/2021,1029,3266,24,154607,129675,2709,22223
545,08/09/2021,703,2255,19,155310,131930,2728,20652
546,09/09/2021,685,1384,30,155995,133314,2758,19923
547,10/09/2021,583,1944,14,156578,135258,2772,18548
548,11/09/2021,424,1324,23,157002,136582,2795,17625
549,12/09/2021,259,870,14,157261,137452,2809,17000
550,13/09/2021,357,1498,24,157618,138950,2833,15835
551,14/09/2021,410,1732,12,158028,140682,2845,14501
552,15/09/2021,368,1382,14,158396,142064,2859,13473
553,16/09/2021,279,1269,19,158675,143333,2878,12464
554,17/09/2021,259,850,11,158934,144183,2889,11862
555,18/09/2021,173,2261,10,159107,146444,2899,9764
556,19/09/2021,48,903,6,159155,147347,2905,8903
557,20/09/2021,173,1434,7,159328,148781,2912,7635
558,21/09/2021,160,1039,5,159488,149820,2917,6751
559,22/09/2021,133,805,2,159621,150625,2919,6077
560,23/09/2021,84,786,4,159705,151411,2923,5371
561,24/09/2021,88,651,8,159793,152062,2931,4800
562,25/09/2021,77,696,5,159870,152758,2936,4176
563,26/09/2021,23,591,3,159893,153349,2939,3605
564,27/09/2021,68,323,8,159961,153672,2947,3342
565,28/09/2021,66,221,2,160027,153893,2949,3185
566,29/09/2021,45,298,4,160072,154191,2953,2928
567,30/09/2021,42,409,2,160114,154600,2955,2559
568,01/10/2021,56,281,4,160170,154881,2959,2330
569,02/10/2021,23,114,2,160193,154995,2961,2237
570,03/10/2021,7,199,1,160200,155194,2962,2044
571,04/10/2021,38,185,2,160238,155379,2964,1895
572,05/10/2021,41,198,1,160279,155577,2965,1737
573,06/10/2021,30,94,0,160309,155671,2965,1673
574,07/10/2021,25,362,1,160334,156033,2966,1335
575,08/10/2021,40,149,0,160374,156182,2966,1226
576,09/10/2021,12,77,4,160386,156259,2970,1157
577,10/10/2021,14,74,2,160400,156333,2972,1095
578,11/10/2021,35,79,0,160435,156412,2972,1051
579,12/10/2021,29,36,1,160464,156448,2973,1043
580,13/10/2021,31,150,0,160495,156598,2973,924
581,14/10/2021,20,158,0,160515,156756,2973,786
582,15/10/2021,15,56,0,160530,156812,2973,745
583,16/10/2021,10,82,0,160540,156894,2973,673
584,17/10/2021,1,42,0,160541,156936,2973,632
585,18/10/2021,17,86,1,160558,157022,2974,562
586,19/10/2021,14,61,0,160572,157083,2974,515
587,20/10/2021,18,23,0,160590,157106,2974,510
588,21/10/2021,16,45,0,160606,157151,2974,481
589,22/10/2021,16,33,0,160622,157184,2974,464
590,23/10/2021,13,21,0,160635,157205,2974,456
591,24/10/2021,3,20,1,160638,157225,2975,438
592,25/10/2021,20,31,0,160658,157256,2975,427
593,26/10/2021,22,20,1,160680,157276,2976,428
594,27/10/2021,16,16,0,160696,157292,2976,428
595,28/10/2021,28,25,0,160724,157317,2976,431
596,29/10/2021,25,9,0,160749,157326,2976,447
597,30/10/2021,13,20,1,160762,157346,2977,439
598,31/10/2021,5,14,0,160767,157360,2977,430
599,01/11/2021,21,10,0,160788,157370,2977,441
600,02/11/2021,21,16,1,160809,157386,2978,445
601,03/11/2021,14,16,0,160823,157402,2978,443
602,04/11/2021,14,17,0,160837,157419,2978,440
603,05/11/2021,16,10,0,160853,157429,2978,446
604,06/11/2021,19,5,0,160872,157434,2978,460
605,07/11/2021,8,6,0,160880,157440,2978,462
606,08/11/2021,11,26,0,160891,157466,2978,447
607,09/11/2021,14,17,0,160905,157483,2978,444
608,10/11/2021,6,21,0,160911,157504,2978,429
609,11/11/2021,16,17,1,160927,157521,2979,427
610,12/11/2021,7,13,1,160934,157534,2980,420
611,13/11/2021,14,6,0,160948,157540,2980,428
612,14/11/2021,4,8,0,160952,157548,2980,424
613,15/11/2021,5,22,0,160957,157570,2980,407
614,16/11/2021,17,19,0,160974,157589,2980,405
615,17/11/2021,11,16,0,160985,157605,2980,400
616,18/11/2021,7,26,1,160992,157631,2981,380
617,19/11/2021,7,34,1,160999,157665,2982,352
618,20/11/2021,7,33,0,161006,157698,2982,326
619,,,,,,,,